                         ______________________________________________
                        /|                                            |\
                       / |                                            | \
                      /  |                                            |  \
                     /   |                                            |   \
                    /    |                                            |    \
                   /     |                                            |     \
                  /      |                                            |      \
                 /       |                                            |       \
                 |       |                                            |       |
                 |       |                                            |       |
                 |       |                                            |       |
                 |       |                                            |       |
                 |       |                                            |       |
                 |       |                                            |       |
                 |       |                                            |       |
                 |       |                                            |       |
                 |       |                                            |       |
                 |       |                                            |       |
                 |       |                     ___                   _|       |
                 |      /                                              \      |
                 |     /                                                \     |
                 |    /                                                  \    |
                 |   /                                                    \   |
                 |  /                                                      \  |
                 | /                                                        \ |
                 |/__________________________________________________________\|



